                 
 ## #      ####$#
  # ##           
 ## # #   ### ###
   # ###   # #  #
 ### ###   ######
  ### ## # ####  
 #   # ##### ## #
 #   #    ## ## #
 #   #       ## #
  ## ##    # ##  
 # #  ## ###   # 
 #    ##    #####
  ##   ##   #$# #
 #         ##  ##
 #    #  #      #
 ###  #  # # # ##
