                 
    ####   # ## #
     #  # ###    
     #####  #    
   # # ###     ##
   # ## ##  ##  #
  #### #### #   #
 ## #  ### #     
 #   ### # $###  
 # # ####  ######
  ##  # ###   ## 
 # # ### #####   
 ## ##  #    # ##
  #     #  ###  #
    ### #   ## # 
  #  #     ######
  #  #     # ### 
